
  111   111  11111 
 1   1 1   1 1    1 
 1   1 1   1 1    1
 1   1 1   1 1 m  1
 1   1 1   1 1    1
 1   1 1   1 1    1
 1 m 1 1 m 1 11111 
 1   1 1   1 1  
 1   1 1   1 1     
 1   1 1   1 1 
 1   1 1   1 1
 1   1 1   1 1 
  111   111  1

s323232323232323232s